فهرست پایتخت‌های ایران در طول تاریخ:

ایلامیان:آوان(دزفول)، شوش، انشان
مادها: هگمتانه
هخامنشیان: هگمتانه، شوش، تخت جمشید و پاسارگاد.
سلوکیان: سلوکیه و انطاکیه.
اشکانیان: دامغان (صددروازه)، تیسپون، هگمتانه، شوش، نسا، ارشاک.
ساسانیان:شهر گور، بیشاپور، تیسفون، همدان ، کرمانشاه، بیشاپور، نهاوند
طاهریان: مرو و نیشابور.
صفاریان: زرنج.
علویان: آمل، ساری، استرآباد.
سامانیان: بخارا.
زیاریان: اصفهان، گرگان، ری.
بوییان: شیراز و همدان
آل حسنویه: بیستون
غزنویان: غزنین و لاهور.
بنی عیاران: کرمانشاه
سلجوقیان: نیشابور، مرو، اصفهان، کرمان و همدان.
اتابکان آذربایجان: تبریز.
اتابکان فارس: شیراز.
اتابکان لر: ایذه و خرم‌آباد.
قراختاییان: کرمان.
خوارزمشاهیان: گرگانج.
ایلخانان: مراغه، سلطانیه و تبریز.
کرتیان: هرات.
مظفریان: کرمان، شیراز، یزد.
سربداران: سبزوار.
چوپانیان: تبریز.
جلایریان: تبریز و بغداد.
تیموریان: سمرقند و هرات.
اسماعیلیه: قزوین و الموت
قراقویونلوها: تبریز.
آق‌قویونلوها: تبریز.
صفویان: تبریز، قزوین و اصفهان.
افشاریان: مشهد.
زندیان: شیراز، ملایر ،کرمان، بم.
قاجاریان: ساری، تهران.
پهلوی: تهران.
جمهوری اسلامی: تهران.


== منابع ==
عباس جوکار دریسی، علی قائد، دامون زابلی، حمید و اکبر سلطانی (۱۳۸۶)، تاریخ معاصر ایران-۲۵۳، تهران: شرکت چاپ و نشر کتاب‌های درسی ایران، ص. صص ۱۰ و ۱۱، شابک ۹۶۴-۰۵-۱۴۳۰-۶